[default_color=bright_black]
      __________________
     |  __  __  __  __ |
     | |  ||  ||  ||  ||
     | |__||__||__||__||
     |  __  __  __  __ |
     | |  ||  ||  ||  ||
     | |__||__||__||__||
     |__________________|
